Begrusugen -> Greetings 
GrusGott-> Hello (mostly in bavaria)
beta sign is the sound of ss in german
Grus Sie!->Formal and Grus Dich! informal
Servus Hello or Bye both 
Tschius-> Bye 
Auf Weidersehen-> See you again
Auf Weiderhohen= Bye on telephone
Bis bald-> See you soon
Bis spater-> See you later
Haufige redemittel= Common phrases
Mein Name ist Harsh. Freut mich, dich kennenzulernen. which translates to pleases me to get to know you.
Vielen Dank or Danke Schon
Bitte Schon or Bitte Welcome or you are welcome
Bitte-> Please
Entschuldigen Sie, Bitte!= Excuse me please 
Entschuldigung Bitte-> informal 
Entschuldigung Excuse me 
Es tut mir Leid-> I am sorry 
Wie bitte?-> I beg your pardon
noch einmal bitte-> Once again please 
Bitte weiderholen sie-> Please repeat
Sprechen sie deutsch?-> Do you speak german
Ich spreche kein deutsch-> I don't speak german 
ich spreche etwas deutsch-> I speak a little german 
ich versteche nicht-> I don't understand
ich weiste niche-> I don't know
keine ahnung-> No idea 
keine problem
einen moment, bitte  
vielleicht-> maybe 
Zahl -> Number Zahlen-> Numbers
null eins zwei drei vier funf sechs(zex) sieben acht neun zehn elf  zwolf 

After 12  the numbers follow the rule of 3+10 4+10 etc:
drei zehn 
vier zehn 
funf zehn
sechzein or sechs zehn 
seibzehn 
achtzehn
neunzehn 
zwanzig twenty

neun acht sieben vier vier eins sechs neun neun eins
Wien heisen zie=> What is your name 
Wie  heist du-> Informal what is your name, 
Ich heise harsh 

Wie ist ihr familienname
Wie ist dein familienname
Mein familienname ist Tandon 

Woher kommen Sie/Woher kommst du 
Ich komme aus India 

Wo wohnen sie/Wo wohnst du-> Ich wohne in Bangalore 

Wie alt sind sie/Wie alt bist du?
Ich bin sibenundzwanzig jahre alt

Welche sprachen sprechen sie/Welche sprachen sprichst du?(Which languages do you speak?)
Ich spreche deutsch, english, hindi und bengali

Was machen sie beruflich/was machst du beruflich(What do you do for a living)-> Ich bin Programmierer
beruf-> profession

Was sind ihre hobbys/Was sind deine hobbys -> What are your hobbies 
noch einmal-> Once more

Meine Hobbys sind Gitarre spielen und Laufen

Sind sie verheiratet/bist du verheiratet(Are you married?)

Haben sie kinder/hast du kinder?

Schonen tag noch-> Have a nice day 
Kalte/Kalt-> Cold, Knie-> Knee 
hosenmatz-> Childlike 

sagtest du nicht gerade, du hattest kalte knie -> Did you just say you had cold knees? 
sich ins knie schiesen-> Shoot yourself in the knee 
die kalte-> The cold 

Ich mag die kaelte nicht-> I don't like the cold 

Brauchst-> To need, brauchen

Du brauchst eine neue hose->You need a new pair of pants 

will-> want 
auch-> Also (Mein vater ist auch Arzt)

Kuchen-> cake

Wie geht's-> How are you?

Wie geht es ehnen-> How are you (formal)
Wie geht es dir-> How are you(informal)

Mir geht es gut-> I am fine 
Mir geht es sehr gut-> I am very well 
Super-Super Wunderbar-> wonderful 
ausgezeichnet-> Excellent 
toll-> Awesome 
prima-> Great 
Fantastich-> Fantastic 
es geht-> Not too bad 
Mir geht es schlecht-> I am not doing well 
Mir geht es nicht gut-> I am not so well 
Mir geht es sehr schlecht-> I am feeling very bad 
schlecht-> bad 
Miserabel-> Miserable 
furchtbar-> Awful 
Ich bin muede-> I am tired
ich bin krank-> I am unwell 
Und ihnen/Und dir-> And you?
Auch gut, danke-> Also good thanks 
Satzstruktur-> Sentence structure 
Ich heiẞe monika-> Ich is the subject, heiẞe is the verb 
Ich wohne in berlin- Ich is the subject, wohne is the verb
Wo wohnen sie-> Sie is the subject wohnen is the verb
Woher kommst du-> Du is the subject and kommst is the verb 
Wie heiẞen sie-> Sie is the subject and heiẞen is the verb 
sprechen sie deutsch-> Do you speak german?
Teil-> part 
kommen-> to come 
ich komme 
du kommst 
sie kommen 

ich heiẞe 
du heiẞt
sie heiẞen 

ich spreche 
du sprichst 
sie sprechen 

Ubung-> exercise 

Mir geht's schon viel besser-> I am already feeling much better 

ich hol mehr-> I will get more

Spukhaus-> haunted house 
Freund => Friend
Was beteutet Freund-> What does Freund mean?
haschen-> Bunny
Arzt-> Doctor
die Wahrheit-> The truth
Sagt Joey ihr die Wahrheit-> Does joey tell her the truth?
schon-> Already


Wie ist es in -> What is it like in 

Da-> There 
Da ist er-> There he is
Das wetter

alles klar-> All good/alright

ich weiss- I know 

kellnerin-> Waitress 
Kellner

interessant-> Interesting


koche-> cook 
schwimme-> swim 

male-> Paint 
manschmal-> Sometimes 
oft= often 
immer-> Always 
schach-> chess 
nie-> never

spiele-> Play

ich spiele, du spielst -> I play you play 

lecker-> tasty

sie spielt-> She plays

Er schwimmt-> He swims 

klavier-> Piano 

malt er immer-> Does he always paint

rechts-> Right(direction)
richtig-> Right(correct)
korrekt-> correct 

alt-> Old 
U-Bahnstation-> Subway stations

Der Geldautomat ist da drüben.-> The atm is over there 
teuer= expensive 
aufregend= exciting
billig-> Cheap 

Universtat-> University 
neu-> New 

die Kirche-> The church

weit-> Far 
weg-> Away 
bahnhof-> Train station 

Wo ist der park-> Where is the park 

Kanzlerin-> Chancellor 

Sind sie frau klum-> Are you Ms klum?

polizist-> Police 

Heisen sie anna?-> Is your name anna 

ich spreche deutsch und englisch-> I speak german and english 

nein, ich spreche kein englisch-> No, I don't speak english 

Und sie, Wie heisen sie-> And you, what is your name?

Anwalt-> Lawyer 
Anwaltin-> Female lawyer 

Kunstler-> Artist

Bist du kunstler Max-> Are you an artist max?

Ja ich wohne in Kanada-> Yes I live in canada

Tasche-> Bag 
Nahe-> Nearby 

Gern Geschehen- You are welcome 
Brot-> bread

Das brot kostet drei dollar und ist sehr lecker-> The bread costs 3 dollars and is very tasty

mit-> With

Die pizza mit kase kostet sieben euro

Erdbeeren->> Strawberries 

Wie viel-> How much

Wirklich-> Really 
voll-> Full

Gerne-> With pleasure 
helfer-> Helper

ich-> Singular
wir-> Plural 

Ich wohne in new york-> I live in new york 
Wir wohnen in new york-> We live in new york 


du -> You informal  
ihr-> You all informal 

Max , wo wohnst du? -> Max, where do you live

Julia und  Max, wo wohnst ihr?

sie-> You formal 
sie -> Formal plural 

Herr muller, wo wohnen sie?
Herr und Frau Muller, wo wohnen sie? 

er-> He 
Sie-> She 
es-> It 

Sie-> Also they 

Das ist michael. Er wohnt in london

Das ist michaela. Sie wohnt in paris 

Das ist mein buch. Es ist alt 

Das sind petra and josh. Sie wohnen in munich 

Haben and Sein-> Helping verbs 

Haben-> To have 
Sein-> To be 

Ich habe ein auto-> I have a car 
Sind sie verheiratet-> Are you married 

haben types:

ich habe 
du hast 
sie haben 
er/sie/es hat 


wir haben 
ihr habt 
sie haben 


Ich habe eine haus
Hast du eine freundin 
Wir haben eine auto 
Habt ihr kinder 
Frau Schmidt, habe sie eine moment?
Er hat keine zeit
Maria hat eine tochter 
Meine Eltert haben einen hund 



ich bin 
du bist
sie sind 
er/sie/es ist 

wir sind 
ihr seid 
Sie sind 

heute-> today 
jetzt-> now 
regnet-> raining
stark-> hard 
es-> it 
schneit-> snowing
fruhling-> spring
wasserflasche-> Water bottle 
neblig-> foggy
wanderst-> hike, wandern sie 
Wo wandern sie frau graf-> Where do you hike ms graf
ich wandere -> I hike 
zu-> too 
viel-> Much
Wie viel kostet die sonnencreme-> How much does the sunscreen cost ?
tauchen-> to dive 
kartoffeln-> potatoes 
Da drüben ist das nicht-> It is not over there 
Lieblings-> Favorite 
Das kann nicht sein-> That can't be true 
Sprich mit im-> Talk to him
Nein, ich bin zu nervos-> No I am too nervous
schuhe-> Shoes
sag-> Say (also sagen )
einfach-> just
ich muss heir weg-> I must get away from here 
bewolkt (bevoklt)-> Cloudy
Anna, ist es heute bewolkt-> Anna,Is it cloudy today 
Regenchirm-> Umbrella 
windig-> Windy
herbst-> Fall/Autumn All seasons are der 
der schal ist teuer aber schon-> the scarf is expensive but beautiful
aber-> But
es ist manschmal heizz(with ezzet) im fruhling-> It is sometimes hot in the spring
Wanderst du oft, Anna-> Do you hike often, anna?
Die wasserflache ist sehr grozz-> The waterbottle is very big 
Oh, Sie wandern nie frau graf-> Oh you never hike ms graf?
Es ist nie warm im winter-> It is never warm in winter 
Wanderst du heute? Es ist sehr sonnig. Hier ist die Sonnencreme.(Are you going hiking today? It is very sunny. Here is the sunscreen)
Du wanderst im sommer und ich wandere im herbst

hilfe-> Help
Super, Ich brauche hilfe-> Great I need help 
Mogen sie die rote jacke heir-> Do you like the red jacket here ?
schwarze-> Black 
Oh ja, die rote jacke ist perfekt fur sie-> Oh yes, the red jacket is perfect for you 

Ist deine mutter kellnerin-> Is your mother a Waitress
Was ist dein beruf-> What is your profession?

hast du einen onkel-> Do you have an uncle?
mitbewohner-> with resident/roommate 
Tante-> Aunt 

Liebt dein bruder deinen hund-> Does your brother love your dog 
Wo ist deine partnerin-> Where is your partner 
Oma-> Grandma 
Opa-> Grandpa 

Ja meine schneke kommt aus Osterreich-> Yes my snail is from austria 
hast du einen mann-> Do you have a husband?
Mein Onkel hat einen sohn-> My uncle has a son 
Er liebt dienen bruder-> He loves your brother 
Das ist zu viel-> That is too much 
